{
    "values": [
        [2, 2, 2, 2, 2, 2, 3, 2],
        [2, 3, 4, 4, 2, 4, 4, 3],
        [2, 2, 4, 2, 3, 4, 2, 3],
        [4, 4, 4, 3, 2, 2, 2, 2],
        [2, 2, 2, 3, 2, 3, 3, 4],
        [4, 4, 3, 4, 4, 2, 2, 2]
    ],
    "row_goals": [12, 11, 20, 21, 12, 20],
    "col_goals": [12, 15, 16, 12, 13, 10, 7, 11]
}